**********G******************
*       *                   *
* ************************* *
* *            *            *
* ****** ****************** *
*              *            *
* ****** ****************** *
* *                         *
* ************************* *
* *       *         *       *
* ******* ********* *********
*                           *
****** ******* ****** ***** *
*            *            * *
******** *********** ********
* * *  *      * *  * * *    *
* * * ******* * ** * * **** * 
* * * * * * * *  * * *    * *
************* ****** ********
*           * *             *
* ********* * * *********** *
* *       * * * *         * *
* * ***** *   * *** *****   *
* * *   * ***** *       *****
* * * * *       * *******   *
* * * * ********* *       * *
* * * * *           ******* *
* *   * *************       *
* *****           * ******* *
*       ********* *   *   * *
********* * * * * * *   * * *
* * * * * * ***** * ******* *
* * * * * * *     *         *
*************S***************