*********G*******************
*       *                   *
* ************************* *
* *            *            *
* ****** ****************** *
*              *            *
* ****** ****************** *
* *                         *
* ************************* *
* *       *         *       *
* ******* ********* *********
*                           *
****** ******* ****** ***** *
*            *            * *
******** *********** ********
*      *      *    * *      *
************* ****** ******** 
*           * *    * *      *
************* ****** ********
*           * *             *
* ********* * * *********** *
* *       * * * *         * *
* * ***** *   * *** *****   *
* * *   * ***** *       *****
* * * * *       * *******   *
* * * * ********* *       * *
* * * * *           ******* *
* *   * *************       *
* *****   *   *   * ******* *
*       *   *   * *   *   * *
***************** * *   * * *
* * * * * * *   * * ******* *
* * * * * * * *   *         *
*************S***************